ハガ: 羽贺
    羽賀誠
ニコラ: 妮可拉
アマノ: 天野
アキラ: 明
ジン: 神
    神林裕翔
スズキ: 铃木
    鈴木洋平
ナミコ: 波子
    平波子
クロちゃん: 小黑
    黒崎優
社長: 社长
サカイ: 酒井
スミダ: 隅田
カナ: 加奈

ホイモイドラゴン: 霍伊莫伊龙
王の探求者(キングス・シーカー): 王国探索者
ニシマテック: 二岛科技

フェルナーク大陸: 费尔纳克大陆
怒りの海: 怒涛之海
銀諸島: 银诸岛
クレボーン島: 克莱伯恩岛
ウィルソード帝国: 维尔索德帝国
リオーノ王国: 利奥诺王国
サイ公国: 赛因公国
ベイル王国: 贝伊鲁王国
スタマウ諸王連合: 斯塔马乌联合国
ルイザ村: 路伊萨村
ザカン高原: 萨冈高原